###################
#      o   o      #
# ### # ### # ### #
# # #o#     #o# # #
# ### # # # # ### #
#     #o# #o#     #
# ##### # # ##### #
#o# o         o #o#
# # #####o##### # #
#                 #
# ##### ### ##### #
#  o    # #    o  #
# ### # ### # ### #
# # # #  o  # # # #
#o###o#o###o#o###o#
#     # # # #     #
# ##### ### ##### #
#       CCC       #
###################
